XXXXXXXXXXXXXXXXXXXXXXXXX
X  XXXXXXX          XXXXX
X  XXXXXXX  XXXXXX  XXXXX
X       XX  XXXXXX  XXXXX
X       XX  XXX        XX
XXXXXX  XX  XXX        XX
XXXXXX  XX  XXXXXX  XXXXX
XXXXXX  XX    XXXX  XXXXX
X  XXX        XXXX  XXXXX
X  XXX  XXXXXXXXXXXXXXXXX
X         XXXXXXXXXXXXXXX
X                XXXXXXXX
XXXXXXXXXXXX     XXXXX  X
XXXXXXXXXXXXXXX  XXXXX  X
XXX  XXXXXXXXXX         X
XXX                     X
XXX         XXXXXXXXXXXXX
XXXXXXXXXX  XXXXXXXXXXXXX
XXXXXXXXXX              X
XX   XXXXX              X
XX   XXXXXXXXXXXXX  XXXXX
XX    XXXXXXXXXXXX  XXXXX
XX          XXXX        X
XXXX                    X
